
######################################
#                                    #
#           z                    z   #
#                    z               #
#  z                                 #
#                        z           #
#       z                       z    #
#                                    #
#                                    #
                        x            #
                                     #
#                                    #
#          z                         #
#                                    #
#                   z         z      #
#    z    z                          #
#                                    #
# z                           z      
#              z                     
######################################